0 0 0 0 0 0 0 0 0 0 0 0 0 0 0 0 0 0 0 0 0 0 0 0 0 0 0 0 0 0 0 0 0 0 0 0 0 0 0 0 0 0 0 0 0 0 0 0 0 0 
0 0 0 0 0 0 0 0 0 0 0 0 0 0 0 0 0 0 0 0 0 0 0 0 0 0 0 0 0 0 0 0 0 0 0 0 0 0 0 0 0 0 0 0 0 0 0 0 0 0 
0 0 0 0 0 0 0 0 0 0 0 0 0 0 0 0 0 0 0 0 0 0 0 0 0 0 0 0 0 0 0 0 0 0 0 0 0 0 0 0 0 0 0 0 0 0 0 0 0 0 
0 0 0 0 0 0 0 0 0 0 0 0 0 0 0 0 0 0 0 0 0 0 0 0 0 0 0 0 0 0 0 0 0 0 0 0 0 0 0 0 0 0 0 0 0 0 0 0 0 0 
0 0 0 0 0 0 0 0 0 0 0 0 0 0 0 0 0 0 0 0 0 0 0 0 0 0 0 0 0 0 0 0 0 0 0 0 0 0 0 0 0 0 0 0 0 0 0 0 0 0 
0 0 0 0 0 0 0 0 0 0 0 0 0 0 0 0 0 0 0 0 0 0 0 0 0 0 0 0 0 0 0 0 0 0 0 0 0 0 0 0 0 0 0 0 0 0 0 0 0 0 
0 0 0 0 0 0 0 47 47 47 47 47 47 47 47 47 47 47 47 47 47 47 47 47 47 47 47 47 47 47 47 47 47 47 47 47 47 47 47 47 47 47 47 0 0 0 0 0 0 0
0 0 0 0 0 0 0 47 45 39 47 47 47 47 47 47 47 47 47 47 47 47 47 47 47 47 47 47 47 47 47 47 47 47 47 47 47 47 47 47 47 47 47 0 0 0 0 0 0 0
0 0 0 0 0 0 0 47 39 39 47 47 47 47 47 39 39 39 39 39 39 47 47 47 47 47 47 47 47 47 47 39 39 39 39 39 39 47 47 47 47 47 47 0 0 0 0 0 0 0
0 0 0 0 0 0 0 47 47 39 47 47 47 47 39 39 39 39 39 39 39 39 47 47 47 47 47 47 47 47 39 39 39 39 47 47 39 47 47 47 47 47 47 0 0 0 0 0 0 0
0 0 0 0 0 0 0 47 47 39 39 39 39 39 39 39 39 39 39 39 39 39 47 47 47 47 39 39 39 39 39 39 39 47 47 47 39 39 47 47 47 47 47 0 0 0 0 0 0 0
0 0 0 0 0 0 0 47 47 47 47 47 47 47 39 39 39 39 39 39 39 39 47 47 47 39 39 39 39 39 39 39 47 47 47 47 47 39 47 47 47 47 47 0 0 0 0 0 0 0
0 0 0 0 0 0 0 47 47 47 47 47 47 47 47 39 39 39 39 39 39 47 47 47 39 39 39 39 39 39 47 47 47 47 47 47 47 39 39 47 47 47 47 0 0 0 0 0 0 0
0 0 0 0 0 0 0 47 47 47 47 47 47 47 47 47 47 47 39 47 47 47 47 39 39 39 39 47 47 47 47 47 47 47 47 47 39 39 39 39 47 47 47 0 0 0 0 0 0 0
0 0 0 0 0 0 0 47 47 47 47 47 47 47 47 47 47 47 39 47 47 47 39 39 39 47 47 47 47 47 47 47 47 47 47 39 39 39 39 39 47 47 47 0 0 0 0 0 0 0
0 0 0 0 0 0 0 47 47 47 47 47 47 47 47 39 39 39 39 39 47 47 39 39 39 47 47 39 47 47 47 47 47 47 47 39 39 39 39 39 39 47 47 0 0 0 0 0 0 0
0 0 0 0 0 0 0 47 47 47 47 47 47 39 39 39 47 39 39 39 47 47 39 47 47 47 47 39 47 47 47 47 47 47 39 39 39 39 39 39 39 47 47 0 0 0 0 0 0 0
0 0 0 0 0 0 0 47 39 39 47 47 47 47 47 47 47 47 39 47 47 47 39 47 47 39 39 39 39 39 47 47 39 39 39 47 47 39 39 39 47 47 47 0 0 0 0 0 0 0
0 0 0 0 0 0 0 47 39 39 39 39 39 47 47 47 47 47 39 47 47 47 39 47 47 39 39 39 39 39 47 39 39 47 47 47 47 47 39 47 47 47 47 0 0 0 0 0 0 0
0 0 0 0 0 0 0 47 39 39 39 39 39 47 47 47 47 47 39 47 47 47 39 47 47 39 39 39 39 39 39 39 47 47 47 47 47 47 39 47 47 47 47 0 0 0 0 0 0 0
0 0 0 0 0 0 0 47 39 39 39 39 39 47 47 47 47 47 39 47 47 47 39 47 47 47 39 39 39 39 47 47 47 47 47 47 47 47 39 47 47 47 47 0 0 0 0 0 0 0
0 0 0 0 0 0 0 47 39 39 39 39 39 47 47 47 47 47 39 47 47 47 39 39 47 47 47 47 47 47 47 47 47 47 47 47 47 47 39 47 47 47 47 0 0 0 0 0 0 0
0 0 0 0 0 0 0 47 47 47 39 47 47 47 47 47 47 47 39 47 39 39 39 39 47 47 47 47 47 47 47 47 47 47 47 47 47 47 39 47 47 47 47 0 0 0 0 0 0 0
0 0 0 0 0 0 0 47 47 47 39 47 47 47 47 47 47 47 39 47 47 47 47 47 47 47 47 47 47 47 47 47 47 47 47 47 47 39 39 39 39 47 47 0 0 0 0 0 0 0
0 0 0 0 0 0 0 47 47 47 39 47 47 47 39 39 39 39 39 39 39 39 47 47 47 47 47 47 47 47 47 47 47 47 39 39 39 39 39 39 39 47 47 0 0 0 0 0 0 0
0 0 0 0 0 0 0 47 47 47 39 47 47 39 39 39 39 39 39 39 39 39 39 47 47 47 47 47 47 47 47 47 39 39 39 39 39 39 39 39 39 47 47 0 0 0 0 0 0 0
0 0 0 0 0 0 0 47 47 47 39 39 39 39 39 39 39 39 39 39 39 39 39 47 47 47 47 47 47 47 47 47 39 39 39 39 39 39 39 39 39 47 47 0 0 0 0 0 0 0
0 0 0 0 0 0 0 47 47 47 39 39 39 39 39 39 39 39 39 39 39 39 39 47 47 47 47 47 47 47 47 47 39 39 39 39 39 39 39 39 39 47 47 0 0 0 0 0 0 0
0 0 0 0 0 0 0 47 47 47 47 47 47 47 39 39 39 39 39 39 39 39 39 39 39 39 39 39 39 39 39 39 39 39 39 39 39 47 47 39 39 47 47 0 0 0 0 0 0 0
0 0 0 0 0 0 0 47 47 47 47 47 47 47 47 47 47 39 39 47 47 47 47 47 47 47 39 47 47 47 47 47 39 39 39 47 47 47 47 39 39 47 47 0 0 0 0 0 0 0
0 0 0 0 0 0 0 47 47 47 47 47 47 47 47 47 47 39 39 47 47 47 47 47 47 47 39 47 47 47 47 47 47 47 47 47 47 47 39 39 39 47 47 0 0 0 0 0 0 0
0 0 0 0 0 0 0 47 47 47 47 47 47 47 47 47 47 39 39 47 47 47 47 47 47 47 39 47 47 47 47 47 47 47 47 47 47 47 47 39 39 47 47 0 0 0 0 0 0 0
0 0 0 0 0 0 0 47 47 47 47 47 47 47 47 47 47 39 39 47 47 47 47 47 47 47 39 47 47 47 47 47 47 47 47 47 47 47 47 47 47 47 47 0 0 0 0 0 0 0
0 0 0 0 0 0 0 47 47 47 47 47 47 47 47 47 47 39 39 47 47 47 47 47 47 39 39 39 47 47 47 47 47 47 47 47 47 47 47 47 47 47 47 0 0 0 0 0 0 0
0 0 0 0 0 0 0 47 47 47 47 47 47 47 47 47 47 39 39 47 47 47 47 47 47 39 39 39 47 47 47 47 47 47 47 47 47 47 47 47 47 47 47 0 0 0 0 0 0 0
0 0 0 0 0 0 0 47 47 47 47 47 47 47 47 39 39 39 39 39 39 47 47 47 47 47 47 47 47 47 47 47 47 47 47 47 47 47 47 47 47 47 47 0 0 0 0 0 0 0
0 0 0 0 0 0 0 47 47 47 47 47 47 47 47 39 39 39 39 39 39 47 47 47 47 47 47 47 47 47 47 47 47 47 47 47 47 47 47 47 47 47 47 0 0 0 0 0 0 0
0 0 0 0 0 0 0 47 47 39 39 39 39 39 39 39 39 39 39 39 39 47 47 47 47 47 47 47 47 47 47 47 47 47 47 47 39 39 39 39 39 47 47 0 0 0 0 0 0 0
0 0 0 0 0 0 0 47 47 39 47 47 47 47 47 39 39 39 39 39 39 47 47 47 47 47 47 47 47 47 47 47 39 39 39 39 39 39 47 47 39 47 47 0 0 0 0 0 0 0
0 0 0 0 0 0 0 47 47 39 47 47 47 47 47 39 39 39 39 39 39 47 47 47 47 47 47 47 47 47 47 39 39 39 39 39 39 47 47 47 39 47 47 0 0 0 0 0 0 0
0 0 0 0 0 0 0 47 39 39 39 47 47 47 47 39 39 39 39 39 39 39 39 39 39 39 39 39 39 39 39 39 39 39 39 39 39 47 47 47 39 47 47 0 0 0 0 0 0 0
0 0 0 0 0 0 0 47 39 46 39 47 47 47 47 47 47 47 47 47 47 47 47 47 47 47 47 47 47 47 47 47 39 39 39 39 39 47 47 47 39 47 47 0 0 0 0 0 0 0
0 0 0 0 0 0 0 47 39 39 39 47 47 47 47 47 47 47 47 47 47 47 47 47 47 47 47 47 47 47 47 47 47 47 47 47 47 47 47 47 47 47 47 0 0 0 0 0 0 0
0 0 0 0 0 0 0 47 47 47 47 47 47 47 47 47 47 47 47 47 47 47 47 47 47 47 47 47 47 47 47 47 47 47 47 47 47 47 47 47 47 47 47 0 0 0 0 0 0 0
0 0 0 0 0 0 0 0 0 0 0 0 0 0 0 0 0 0 0 0 0 0 0 0 0 0 0 0 0 0 0 0 0 0 0 0 0 0 0 0 0 0 0 0 0 0 0 0 0 0 
0 0 0 0 0 0 0 0 0 0 0 0 0 0 0 0 0 0 0 0 0 0 0 0 0 0 0 0 0 0 0 0 0 0 0 0 0 0 0 0 0 0 0 0 0 0 0 0 0 0 
0 0 0 0 0 0 0 0 0 0 0 0 0 0 0 0 0 0 0 0 0 0 0 0 0 0 0 0 0 0 0 0 0 0 0 0 0 0 0 0 0 0 0 0 0 0 0 0 0 0 
0 0 0 0 0 0 0 0 0 0 0 0 0 0 0 0 0 0 0 0 0 0 0 0 0 0 0 0 0 0 0 0 0 0 0 0 0 0 0 0 0 0 0 0 0 0 0 0 0 0 
0 0 0 0 0 0 0 0 0 0 0 0 0 0 0 0 0 0 0 0 0 0 0 0 0 0 0 0 0 0 0 0 0 0 0 0 0 0 0 0 0 0 0 0 0 0 0 0 0 0 
0 0 0 0 0 0 0 0 0 0 0 0 0 0 0 0 0 0 0 0 0 0 0 0 0 0 0 0 0 0 0 0 0 0 0 0 0 0 0 0 0 0 0 0 0 0 0 0 0 0 
